{
  " ": " ",
  ".": ".",
  "a": "a",
  "e": "e",
  "f": "f",
  "i": "i",
  "j": "j",
  "k": "k",
  "kʰ": "kʰ",
  "l": "l",
  "m": "m",
  "n": "n",
  "o": "o",
  "p": "p",
  "pʰ": "pʰ",
  "s": "s",
  "sʰ": "sʰ",
  "t": "t",
  "tʰ": "tʰ",
  "u": "u",
  "w": "w",
  "x": "x",
  "y": "y",
  "ŋ": "ŋ",
  "œ": "œ",
  "ɑ": "ɑ",
  "ɔ": "ɔ",
  "ɕ": "ɕ",
  "ɕʰ": "ɕʰ",
  "ə": "ə",
  "ɛ": "ɛ",
  "ɤ": "ɤ",
  "ɥ": "ɥ",
  "ɨ": "ɨ",
  "ɪ": "ɪ",
  "ɯ": "ɯ",
  "ɻ": "ɻ",
  "ʂ": "ʂ",
  "ʂʰ": "ʂʰ",
  "ʈ": "ʈ",
  "ʊ": "ʊ",
  "ʐ": "ʐ",

  ",": "",
  ";": "",
  "b": "p",
  "d": "t",
  "h": "x",
  "r": "ɻ",
  "v": "w",
  "z": "ɕ",
  "æ": "a",
  "ç": "ɕ",
  "ð": "s",
  "ɚ": "e",
  "ɝ": "e",
  "ɡ": "k",
  "ɹ": "ɻ",
  "ɹ̩": "ɻ",
  "ɾ": "ɻ",
  "ʃ": "ʂ",
  "ʌ": "ɑ",
  "ʏ": "y",
  "ʒ": "ɕ",
  "ˈ": "",
  "ˌ": "",
  "ː": "",
  "θ": "s"
}