{
  " ": " ",
  ",": ",",
  ".": ".",
  ";": ";",
  "a": "a",
  "b": "b",
  "d": "d",
  "e": "e",
  "f": "f",
  "h": "h",
  "i": "i",
  "j": "j",
  "k": "k",
  "l": "l",
  "m": "m",
  "n": "n",
  "o": "o",
  "p": "p",
  "s": "s",
  "t": "t",
  "u": "u",
  "v": "v",
  "w": "w",
  "z": "z",
  "æ": "æ",
  "ð": "ð",
  "ŋ": "ŋ",
  "ɑ": "ɑ",
  "ɔ": "ɔ",
  "ə": "ə",
  "ɛ": "ɛ",
  "ɡ": "ɡ",
  "ɪ": "ɪ",
  "ɹ": "ɹ",
  "ɹ̩": "ɹ̩",
  "ʃ": "ʃ",
  "ʊ": "ʊ",
  "ʌ": "ʌ",
  "ʒ": "ʒ",
  "θ": "θ",

  "kʰ": "k",
  "pʰ": "p",
  "r": "ɹ",
  "sʰ": "s",
  "tʰ": "t",
  "x": "h",
  "y": "u",
  "ç": "ʃ",
  "œ": "ɛ",
  "ɕ": "ʃ",
  "ɕʰ": "ʃ",
  "ɚ": "",
  "ɝ": "",
  "ɤ": "ʊ",
  "ɥ": "u",
  "ɨ": "ʊ",
  "ɯ": "ʊ",
  "ɻ": "ɹ",
  "ɾ": "",
  "ʂ": "ʃ",
  "ʂʰ": "ʃ",
  "ʈ": "t",
  "ʏ": "u",
  "ʐ": "ʒ",
  "ˈ": "",
  "ˌ": "",
  "ː": ""
}