{
  " ": " ",
  ".": ".",
  "?": "?",
  "_": "_",
  "a": "a",
  "e": "e",
  "f": "f",
  "i": "i",
  "j": "j",
  "k": "k",
  "l": "l",
  "m": "m",
  "n": "n",
  "o": "o",
  "p": "p",
  "s": "s",
  "t": "t",
  "u": "u",
  "w": "w",
  "~": "~",
  "ŋ": "ŋ",
  "ɑ": "ɑ",
  "ɔ": "ɔ",
  "ə": "ə",
  "ɛ": "ɛ",
  "ɪ": "ɪ",
  "ʊ": "ʊ",
  
  "kʰ": "k",
  "pʰ": "p",
  "sʰ": "s",
  "tʰ": "t",
  "x": "h",
  "y": "u",
  "œ": "ɛ",
  "ɕ": "ʃ",
  "ɕʰ": "ʃ",
  "ɤ": "ʊ",
  "ɥ": "u",
  "ɨ": "ʊ",
  "ɯ": "ʊ",
  "ɻ": "ɹ",
  "ʂ": "ʃ",
  "ʂʰ": "ʃ",
  "ʈ": "t",
  "ʐ": "ʒ"
}