{
  ".": ".",
  " ": " ",
  "_": "_",
  "~": "~",
  "?": "?",
  "a": "a",
  "ɑ": "ɑ",
  "j": "j",
  "u": "u",
  "i": "i",
  "ɪ": "ɪ",
  "e": "e",
  "ə": "ə",
  "ɛ": "ɛ",
  "ŋ": "ŋ",
  "ʊ": "ʊ",
  "m": "m",
  "ɔ": "ɔ",
  "w": "w",
  "n": "n",
  "p": "p",
  "s": "s",
  "o": "o",
  "k": "k",
  "t": "t",
  "l": "l",
  "f": "f",

  "ɯ": "ʊ",
  "ɨ": "ʊ",
  "ɤ": "ʊ",
  "y": "u",
  "ɥ": "u",
  "x": "h",
  "kʰ": "k",
  "pʰ": "p",
  "tʰ": "t",
  "ɕ": "ʃ",
  "ɕʰ": "ʃ",
  "ʐ": "ʒ",
  "sʰ": "s",
  "ʂ": "ʃ",
  "ʂʰ": "ʃ",
  "ɻ": "ɹ",
  "œ": "ɛ",
  "ʈ": "t"
}