{
  " ": " ",
  ".": ".",
  "?": "?",
  "_": "_",
  "a": "a",
  "e": "e",
  "f": "f",
  "i": "i",
  "j": "j",
  "k": "k",
  "l": "l",
  "m": "m",
  "n": "n",
  "o": "o",
  "p": "p",
  "s": "s",
  "t": "t",
  "u": "u",
  "w": "w",
  "~": "~",
  "ŋ": "ŋ",
  "ɑ": "ɑ",
  "ɔ": "ɔ",
  "ə": "ə",
  "ɛ": "ɛ",
  "ɪ": "ɪ",
  "ʊ": "ʊ",
  
  "!": "",
  "\"": "",
  "(": "",
  ")": "",
  ",": "",
  "-": "",
  ":": "",
  ";": "",
  "[": "",
  "]": "",
  "b": "p",
  "d": "t",
  "h": "x",
  "v": "w",
  "z": "ɕ",
  "æ": "a",
  "ð": "s",
  "ɡ": "k",
  "ɹ": "ɻ",
  "ɹ̩": "ɻ",
  "ʃ": "ʂ",
  "ʌ": "ɑ",
  "ʒ": "ɕ",
  "θ": "s"
}