{
  "ɯ": "ʊ",
  "ɨ": "ʊ",
  "ɤ": "ʊ",
  "y": "u",
  "ɥ": "u",
  "x": "h",
  "kʰ": "k",
  "pʰ": "p",
  "tʰ": "t",
  "ɕ": "ʃ",
  "ʐ": "ʒ",
  "ʂ": "ʃ",
  "ɻ": "ɹ",
  "œ": "ɛ"
}